acc,ref_acc,date,year,Nₛᵧₘ,Nₐₚₒₛᵧₘ,Nₐₚₒₛᵧₘ⁻¹,Nₐ₊₋,Oₛᵧₘ,Oₐₚₒₛᵧₘ,Oₐₚₒₛᵧₘ⁻¹,Oₐ₊₋,pₛᵧₘ,pₐₚₒₛᵧₘ,pₐₚₒₛᵧₘ⁻¹,pₐ₊₋
KJ642616,OP123045,1968-01-01,1968,96001.0,2964,7902,10866,155,7,35,42,0.0016145665149321362,0.0023616734143049934,0.00442925841559099,0.006790931829895984
KJ642617,OP123045,1971-01-01,1971,103052.0,3185,8494,11679,40,0,27,27,0.0003881535535457827,0.0,0.0031787143866258537,0.0031787143866258537
KP849470,OP123045,1971-01-01,1971,92757.0,2851,7625,10476,153,8,34,42,0.0016494711989391635,0.0028060329708874078,0.004459016393442623,0.0072650493643300305
NC_003310,OP123045,1996-01-01,1996,96624.0,2966,7937,10903,378,27,43,70,0.003912071535022355,0.009103169251517195,0.005417664104825501,0.014520833356342695
JX878428,OP123045,2007-01-01,2007,95894.0,2944,7872,10816,356,24,42,66,0.0037124324775272698,0.008152173913043478,0.005335365853658537,0.013487539766702014
JX878410,OP123045,2007-01-01,2007,90828.0,2783,7461,10244,328,22,40,62,0.0036112212093187125,0.007905138339920948,0.0053612116338292454,0.013266349973750194
MK783028,OP123045,2017-01-01,2017,103050.0,3185,8494,11679,25,0,23,23,0.00024260067928190198,0.0,0.002707793736755357,0.002707793736755357
MK783030,OP123045,2017-01-01,2017,103050.0,3185,8494,11679,29,4,23,27,0.0002814167879670063,0.0012558869701726845,0.002707793736755357,0.003963680706928041
MK783032,OP123045,2017-01-01,2017,103050.0,3185,8494,11679,25,0,23,23,0.00024260067928190198,0.0,0.002707793736755357,0.002707793736755357
MK783031,OP123045,2017-01-01,2017,103050.0,3185,8494,11679,26,1,23,24,0.0002523047064531781,0.0003139717425431711,0.002707793736755357,0.003021765479298528
MK783029,OP123045,2017-01-01,2017,103050.0,3185,8494,11679,26,0,23,23,0.0002523047064531781,0.0,0.002707793736755357,0.002707793736755357
MT903337,OP123045,2018-01-01,2018,103055.0,3185,8494,11679,27,1,23,24,0.00026199602154189513,0.0003139717425431711,0.002707793736755357,0.003021765479298528
MT903340,OP123045,2018-01-01,2018,103055.0,3186,8494,11680,28,3,23,26,0.00027169957789529865,0.0009416195856873823,0.002707793736755357,0.003649413322442739
MN648051,OP123045,2018-01-01,2018,103014.0,3184,8490,11674,22,0,19,19,0.00021356320500126195,0.0,0.002237926972909305,0.002237926972909305
MT903343,OP123045,2018-01-01,2018,103055.0,3186,8494,11680,21,0,19,19,0.00020377468342147397,0.0,0.00223687308688486,0.00223687308688486
MT903344,OP123045,2018-01-01,2018,103055.0,3186,8494,11680,19,0,17,17,0.00018436757071466694,0.0,0.0020014127619496116,0.0020014127619496116
MT903345,OP123045,2018-01-01,2018,103055.0,3186,8494,11680,19,0,17,17,0.00018436757071466694,0.0,0.0020014127619496116,0.0020014127619496116
NC_063383,OP123045,2018-01-01,2018,103055.0,3186,8494,11680,28,3,23,26,0.00027169957789529865,0.0009416195856873823,0.002707793736755357,0.003649413322442739
MT903342,OP123045,2019-01-01,2019,103055.0,3186,8494,11680,22,1,19,20,0.0002134782397748775,0.00031387319522912746,0.00223687308688486,0.002550746282113987
ON676708,OP123045,2021-01-01,2021,103055.0,3186,8494,11680,7,1,4,5,6.792489447382466e-5,0.00031387319522912746,0.0004709206498704968,0.0007847938450996243
OP257247,OP123045,2022-01-01,2022,103055.0,3186,8494,11680,1,0,1,1,9.703556353403522e-6,0.0,0.0001177301624676242,0.0001177301624676242
ON563414,OP123045,2022-01-01,2022,103055.0,3186,8494,11680,1,0,1,1,9.703556353403522e-6,0.0,0.0001177301624676242,0.0001177301624676242
OP257243,OP123045,2022-01-01,2022,103055.0,3186,8494,11680,1,1,0,1,9.703556353403522e-6,0.00031387319522912746,0.0,0.00031387319522912746
OP123044,OP123045,2022-01-01,2022,103055.0,3186,8494,11680,1,0,1,1,9.703556353403522e-6,0.0,0.0001177301624676242,0.0001177301624676242
OP123045,OP123045,2022-01-01,2022,103055.0,3186,8494,11680,0,0,0,0,0.0,0.0,0.0,0.0
OP123041,OP123045,2022-01-01,2022,103055.0,3186,8494,11680,1,0,1,1,9.703556353403522e-6,0.0,0.0001177301624676242,0.0001177301624676242
OP123040,OP123045,2022-01-01,2022,103055.0,3186,8494,11680,1,0,1,1,9.703556353403522e-6,0.0,0.0001177301624676242,0.0001177301624676242
OP225968,OP123045,2022-01-01,2022,103055.0,3186,8494,11680,1,0,1,1,9.703556353403522e-6,0.0,0.0001177301624676242,0.0001177301624676242
ON649713,OP123045,2022-01-01,2022,98879.0,3045,8178,11223,2,1,1,2,2.0226741775301125e-5,0.0003284072249589491,0.00012227928588897041,0.0004506865108479195
ON843176,OP123045,2022-01-01,2022,103055.0,3186,8494,11680,1,0,1,1,9.703556353403522e-6,0.0,0.0001177301624676242,0.0001177301624676242
ON843174,OP123045,2022-01-01,2022,103055.0,3186,8494,11680,2,0,1,1,1.9407112706807045e-5,0.0,0.0001177301624676242,0.0001177301624676242
ON843173,OP123045,2022-01-01,2022,103055.0,3186,8494,11680,1,0,1,1,9.703556353403522e-6,0.0,0.0001177301624676242,0.0001177301624676242
ON843172,OP123045,2022-01-01,2022,103055.0,3186,8494,11680,1,0,1,1,9.703556353403522e-6,0.0,0.0001177301624676242,0.0001177301624676242
ON694329,OP123045,2022-01-01,2022,103055.0,3186,8494,11680,1,0,1,1,9.703556353403522e-6,0.0,0.0001177301624676242,0.0001177301624676242
ON813267,OP123045,2022-01-01,2022,103055.0,3186,8494,11680,1,0,1,1,9.703556353403522e-6,0.0,0.0001177301624676242,0.0001177301624676242
ON813266,OP123045,2022-01-01,2022,103055.0,3186,8494,11680,1,0,1,1,9.703556353403522e-6,0.0,0.0001177301624676242,0.0001177301624676242
ON813261,OP123045,2022-01-01,2022,103055.0,3186,8494,11680,3,2,1,3,2.911066906021057e-5,0.0006277463904582549,0.0001177301624676242,0.0007454765529258791
ON813255,OP123045,2022-01-01,2022,103055.0,3186,8494,11680,1,0,1,1,9.703556353403522e-6,0.0,0.0001177301624676242,0.0001177301624676242
ON813251,OP123045,2022-01-01,2022,102553.0,3178,8456,11634,1,0,1,1,9.751055551763478e-6,0.0,0.00011825922421948912,0.00011825922421948912
OP215267,OP123045,2022-01-01,2022,103055.0,3186,8494,11680,1,0,1,1,9.703556353403522e-6,0.0,0.0001177301624676242,0.0001177301624676242
