acc,ref_acc,date,year,Nₛᵧₘ,Nₐₚₒₛᵧₘ,Nₐₚₒₛᵧₘ⁻¹,Nₐ₊₋,Oₛᵧₘ,Oₐₚₒₛᵧₘ,Oₐₚₒₛᵧₘ⁻¹,Oₐ₊₋,pₛᵧₘ,pₐₚₒₛᵧₘ,pₐₚₒₛᵧₘ⁻¹,pₐ₊₋
KJ642616,OP225968,1968-01-01,1968,95999.0,2963,7903,10866,154,7,34,41,0.0016041833769101762,0.002362470469119136,0.004302163735290396,0.006664634204409532
KJ642617,OP225968,1971-01-01,1971,103050.0,3184,8495,11679,40,0,27,27,0.00038816108685104316,0.0,0.0031783402001177162,0.0031783402001177162
KP849470,OP225968,1971-01-01,1971,92757.0,2849,7626,10475,152,8,33,41,0.0016386903414297572,0.002808002808002808,0.004327301337529505,0.007135304145532312
NC_003310,OP225968,1996-01-01,1996,96622.0,2965,7938,10903,377,27,42,69,0.0039018029020305932,0.009106239460370995,0.005291005291005291,0.014397244751376286
JX878428,OP225968,2007-01-01,2007,95892.0,2943,7873,10816,355,24,41,65,0.0037020815083635755,0.00815494393476045,0.005207671789660866,0.013362615724421316
JX878410,OP225968,2007-01-01,2007,90828.0,2781,7462,10243,327,22,39,61,0.0036002113885585945,0.007910823444804028,0.005226480836236934,0.013137304281040962
MK783028,OP225968,2017-01-01,2017,103048.0,3184,8495,11679,24,0,22,22,0.00023290117226923375,0.0,0.0025897586815773984,0.0025897586815773984
MK783030,OP225968,2017-01-01,2017,103048.0,3184,8495,11679,28,4,22,26,0.00027171803431410603,0.001256281407035176,0.0025897586815773984,0.003846040088612574
MK783032,OP225968,2017-01-01,2017,103048.0,3184,8495,11679,24,0,22,22,0.00023290117226923375,0.0,0.0025897586815773984,0.0025897586815773984
MK783031,OP225968,2017-01-01,2017,103048.0,3184,8495,11679,25,1,22,23,0.00024260538778045183,0.000314070351758794,0.0025897586815773984,0.0029038290333361924
MK783029,OP225968,2017-01-01,2017,103048.0,3184,8495,11679,25,0,22,22,0.00024260538778045183,0.0,0.0025897586815773984,0.0025897586815773984
MT903337,OP225968,2018-01-01,2018,103053.0,3184,8495,11679,26,1,22,23,0.00025229736155182284,0.000314070351758794,0.0025897586815773984,0.0029038290333361924
MT903340,OP225968,2018-01-01,2018,103053.0,3185,8495,11680,27,3,22,25,0.00026200110622689294,0.0009419152276295133,0.0025897586815773984,0.003531673909206912
MN648051,OP225968,2018-01-01,2018,103012.0,3183,8491,11674,21,0,18,18,0.0002038597444957869,0.0,0.002119891649982334,0.002119891649982334
MT903343,OP225968,2018-01-01,2018,103053.0,3185,8495,11680,20,0,18,18,0.00019407489350140218,0.0,0.002118893466745144,0.002118893466745144
MT903344,OP225968,2018-01-01,2018,103053.0,3185,8495,11680,18,0,16,16,0.00017466740415126198,0.0,0.001883460859329017,0.001883460859329017
MT903345,OP225968,2018-01-01,2018,103053.0,3185,8495,11680,18,0,16,16,0.00017466740415126198,0.0,0.001883460859329017,0.001883460859329017
NC_063383,OP225968,2018-01-01,2018,103053.0,3185,8495,11680,27,3,22,25,0.00026200110622689294,0.0009419152276295133,0.0025897586815773984,0.003531673909206912
MT903342,OP225968,2019-01-01,2019,103053.0,3185,8495,11680,21,1,18,19,0.0002037786381764723,0.0003139717425431711,0.002118893466745144,0.002432865209288315
ON676708,OP225968,2021-01-01,2021,102680.0,3176,8463,11639,6,1,3,4,5.8433969614335804e-5,0.00031486146095717883,0.0003544842254519674,0.0006693456864091462
OP257247,OP225968,2022-01-01,2022,102680.0,3176,8463,11639,0,0,0,0,0.0,0.0,0.0,0.0
ON563414,OP225968,2022-01-01,2022,103053.0,3185,8495,11680,0,0,0,0,0.0,0.0,0.0,0.0
OP257243,OP225968,2022-01-01,2022,102680.0,3176,8463,11639,2,2,0,2,1.9477989871445266e-5,0.0006297229219143577,0.0,0.0006297229219143577
OP123044,OP225968,2022-01-01,2022,102680.0,3176,8463,11639,0,0,0,0,0.0,0.0,0.0,0.0
OP123045,OP225968,2022-01-01,2022,102680.0,3176,8463,11639,1,1,0,1,9.738994935722633e-6,0.00031486146095717883,0.0,0.00031486146095717883
OP123041,OP225968,2022-01-01,2022,102680.0,3176,8463,11639,0,0,0,0,0.0,0.0,0.0,0.0
OP123040,OP225968,2022-01-01,2022,102680.0,3176,8463,11639,0,0,0,0,0.0,0.0,0.0,0.0
OP225968,OP225968,2022-01-01,2022,103053.0,3185,8495,11680,0,0,0,0,0.0,0.0,0.0,0.0
ON649713,OP225968,2022-01-01,2022,98504.0,3035,8147,11182,1,1,0,1,1.0151872005197759e-5,0.00032948929159802305,0.0,0.00032948929159802305
ON843176,OP225968,2022-01-01,2022,103053.0,3185,8495,11680,0,0,0,0,0.0,0.0,0.0,0.0
ON843174,OP225968,2022-01-01,2022,103053.0,3185,8495,11680,1,0,0,0,9.70374467507011e-6,0.0,0.0,0.0
ON843173,OP225968,2022-01-01,2022,103053.0,3185,8495,11680,0,0,0,0,0.0,0.0,0.0,0.0
ON843172,OP225968,2022-01-01,2022,103053.0,3185,8495,11680,0,0,0,0,0.0,0.0,0.0,0.0
ON694329,OP225968,2022-01-01,2022,103053.0,3185,8495,11680,0,0,0,0,0.0,0.0,0.0,0.0
ON813267,OP225968,2022-01-01,2022,102680.0,3176,8463,11639,0,0,0,0,0.0,0.0,0.0,0.0
ON813266,OP225968,2022-01-01,2022,102680.0,3176,8463,11639,0,0,0,0,0.0,0.0,0.0,0.0
ON813261,OP225968,2022-01-01,2022,102680.0,3176,8463,11639,2,2,0,2,1.9477989871445266e-5,0.0006297229219143577,0.0,0.0006297229219143577
ON813255,OP225968,2022-01-01,2022,102680.0,3176,8463,11639,0,0,0,0,0.0,0.0,0.0,0.0
ON813251,OP225968,2022-01-01,2022,102178.0,3168,8425,11593,0,0,0,0,0.0,0.0,0.0,0.0
OP215267,OP225968,2022-01-01,2022,102680.0,3176,8463,11639,0,0,0,0,0.0,0.0,0.0,0.0
