acc,ref_acc,date,year,Nₛᵧₘ,Nₐₚₒₛᵧₘ,Nₐₚₒₛᵧₘ⁻¹,Nₐ₊₋,Oₛᵧₘ,Oₐₚₒₛᵧₘ,Oₐₚₒₛᵧₘ⁻¹,Oₐ₊₋,pₛᵧₘ,pₐₚₒₛᵧₘ,pₐₚₒₛᵧₘ⁻¹,pₐ₊₋
KJ642616,OP062235,1968-01-01,1968,83882.0,2441,6306,8747,134,6,31,37,0.0015974821773443648,0.0024580090126997134,0.004915953060577228,0.007373962073276941
KJ642617,OP062235,1971-01-01,1971,95580.0,2790,7187,9977,39,0,27,27,0.00040803515379786567,0.0,0.003756783080562126,0.003756783080562126
KP849470,OP062235,1971-01-01,1971,76074.0,2214,5717,7931,121,7,29,36,0.0015905565633462155,0.0031616982836495033,0.005072590519503236,0.008234288803152738
NC_003310,OP062235,1996-01-01,1996,83885.0,2450,6333,8783,318,20,36,56,0.0037909042141026405,0.00816326530612245,0.005684509711037423,0.013847775017159874
JX878428,OP062235,2007-01-01,2007,81761.0,2396,6139,8535,288,18,34,52,0.003522461809420139,0.007512520868113523,0.005538361296628116,0.013050882164741638
JX878410,OP062235,2007-01-01,2007,72569.0,2159,5476,7635,250,16,31,47,0.0034449971751023163,0.007410838351088467,0.005661066471877283,0.01307190482296575
MK783028,OP062235,2017-01-01,2017,95574.0,2790,7187,9977,25,0,23,23,0.0002615774164521732,0.0,0.003200222624182552,0.003200222624182552
MK783030,OP062235,2017-01-01,2017,95574.0,2790,7187,9977,29,4,23,27,0.0003034298030845209,0.0014336917562724014,0.003200222624182552,0.004633914380454953
MK783032,OP062235,2017-01-01,2017,95574.0,2790,7187,9977,25,0,23,23,0.0002615774164521732,0.0,0.003200222624182552,0.003200222624182552
MK783031,OP062235,2017-01-01,2017,95574.0,2790,7187,9977,26,1,23,24,0.0002720405131102601,0.00035842293906810036,0.003200222624182552,0.0035586455632506523
MK783029,OP062235,2017-01-01,2017,95574.0,2790,7187,9977,26,0,23,23,0.0002720405131102601,0.0,0.003200222624182552,0.003200222624182552
MT903337,OP062235,2018-01-01,2018,95587.0,2790,7188,9978,26,0,23,23,0.0002720035151223493,0.0,0.003199777406789093,0.003199777406789093
MT903340,OP062235,2018-01-01,2018,95894.0,2802,7214,10016,28,3,23,26,0.00029198907126618977,0.0010706638115631692,0.00318824507901303,0.004258908890576199
MN648051,OP062235,2018-01-01,2018,95486.0,2788,7175,9963,24,0,21,21,0.0002513457470205056,0.0,0.002926829268292683,0.002926829268292683
MT903343,OP062235,2018-01-01,2018,95894.0,2802,7214,10016,23,0,21,21,0.0002398481656829416,0.0,0.002911006376490158,0.002911006376490158
MT903344,OP062235,2018-01-01,2018,95894.0,2802,7214,10016,21,0,19,19,0.00021899180344964232,0.0,0.002633767673967286,0.002633767673967286
MT903345,OP062235,2018-01-01,2018,95894.0,2802,7214,10016,21,0,19,19,0.00021899180344964232,0.0,0.002633767673967286,0.002633767673967286
NC_063383,OP062235,2018-01-01,2018,95894.0,2802,7214,10016,28,3,23,26,0.00029198907126618977,0.0010706638115631692,0.00318824507901303,0.004258908890576199
MT903342,OP062235,2019-01-01,2019,95886.0,2802,7214,10016,24,1,21,22,0.00025029722795820035,0.00035688793718772306,0.002911006376490158,0.003267894313677881
ON676707,OP062235,2021-01-01,2021,95886.0,2802,7214,10016,37,12,22,34,0.00038587489310222556,0.004282655246252677,0.003049625727751594,0.007332280974004271
ON676708,OP062235,2021-01-01,2021,95894.0,2802,7214,10016,8,0,6,6,8.342544893319708e-5,0.0,0.0008317161075686166,0.0008317161075686166
OP257247,OP062235,2022-01-01,2022,95894.0,2802,7214,10016,3,0,3,3,3.1284543349948904e-5,0.0,0.0004158580537843083,0.0004158580537843083
ON563414,OP062235,2022-01-01,2022,95894.0,2802,7214,10016,3,0,3,3,3.1284543349948904e-5,0.0,0.0004158580537843083,0.0004158580537843083
ON674051,OP062235,2022-01-01,2022,95894.0,2802,7214,10016,32,6,22,28,0.0003337017957327883,0.0021413276231263384,0.003049625727751594,0.0051909533508779325
ON675438,OP062235,2022-01-01,2022,95243.0,2786,7168,9954,35,8,23,31,0.00036748107472465167,0.002871500358937545,0.003208705357142857,0.0060802057160804016
ON803417,OP062235,2022-01-01,2022,95892.0,2802,7214,10016,3,0,3,3,3.128519584532599e-5,0.0,0.0004158580537843083,0.0004158580537843083
ON803417,OP062235,2022-01-01,2022,95892.0,2802,7214,10016,3,0,3,3,3.128519584532599e-5,0.0,0.0004158580537843083,0.0004158580537843083
OP062235,OP062235,2022-01-01,2022,100040.0,2851,7355,10206,0,0,0,0,0.0,0.0,0.0,0.0
OP257243,OP062235,2022-01-01,2022,95894.0,2802,7214,10016,5,2,3,5,5.214090558324817e-5,0.0007137758743754461,0.0004158580537843083,0.0011296339281597545
OP123044,OP062235,2022-01-01,2022,95894.0,2802,7214,10016,3,0,3,3,3.1284543349948904e-5,0.0,0.0004158580537843083,0.0004158580537843083
OP123045,OP062235,2022-01-01,2022,95894.0,2802,7214,10016,4,1,3,4,4.171272446659854e-5,0.00035688793718772306,0.0004158580537843083,0.0007727459909720314
OP123041,OP062235,2022-01-01,2022,95894.0,2802,7214,10016,3,0,3,3,3.1284543349948904e-5,0.0,0.0004158580537843083,0.0004158580537843083
OP123040,OP062235,2022-01-01,2022,95894.0,2802,7214,10016,3,0,3,3,3.1284543349948904e-5,0.0,0.0004158580537843083,0.0004158580537843083
OP225968,OP062235,2022-01-01,2022,95894.0,2802,7214,10016,3,0,3,3,3.1284543349948904e-5,0.0,0.0004158580537843083,0.0004158580537843083
ON649713,OP062235,2022-01-01,2022,89656.0,2613,6774,9387,3,1,2,3,3.346122958864995e-5,0.0003827018752391887,0.0002952465308532625,0.0006779484060924512
ON843176,OP062235,2022-01-01,2022,95894.0,2802,7214,10016,3,0,3,3,3.1284543349948904e-5,0.0,0.0004158580537843083,0.0004158580537843083
ON843174,OP062235,2022-01-01,2022,95894.0,2802,7214,10016,4,0,3,3,4.171272446659854e-5,0.0,0.0004158580537843083,0.0004158580537843083
ON843173,OP062235,2022-01-01,2022,95894.0,2802,7214,10016,3,0,3,3,3.1284543349948904e-5,0.0,0.0004158580537843083,0.0004158580537843083
ON843172,OP062235,2022-01-01,2022,95894.0,2802,7214,10016,3,0,3,3,3.1284543349948904e-5,0.0,0.0004158580537843083,0.0004158580537843083
ON694329,OP062235,2022-01-01,2022,95865.0,2801,7212,10013,3,0,3,3,3.129400719762166e-5,0.0,0.00041597337770382697,0.00041597337770382697
ON813267,OP062235,2022-01-01,2022,95894.0,2802,7214,10016,3,0,3,3,3.1284543349948904e-5,0.0,0.0004158580537843083,0.0004158580537843083
ON813266,OP062235,2022-01-01,2022,95894.0,2802,7214,10016,3,0,3,3,3.1284543349948904e-5,0.0,0.0004158580537843083,0.0004158580537843083
ON813261,OP062235,2022-01-01,2022,95894.0,2802,7214,10016,4,1,3,4,4.171272446659854e-5,0.00035688793718772306,0.0004158580537843083,0.0007727459909720314
ON813255,OP062235,2022-01-01,2022,95894.0,2802,7214,10016,3,0,3,3,3.1284543349948904e-5,0.0,0.0004158580537843083,0.0004158580537843083
ON813251,OP062235,2022-01-01,2022,95351.0,2794,7178,9972,3,0,3,3,3.146270096800243e-5,0.0,0.00041794371691278906,0.00041794371691278906
OP215267,OP062235,2022-01-01,2022,95894.0,2802,7214,10016,3,0,3,3,3.1284543349948904e-5,0.0,0.0004158580537843083,0.0004158580537843083
